*   **  *        **   * *  **      *  ** * **    **  *          **  *  *  * ****    * ***   **  ** ***** **   * * ** * *     *      ** *  * ***     **  * * *    **  *** ***      
    *  **** *    ** ** **   * **           *   * * ** * *  * **  ***         **  * * *   * ***    * * *  *** ***  **    *   ** **** *  *    * * **   *   ** * *   **** *  * *     
   * *  * ***   * *** *    *  **  *   *****  * * **   *   *  **     * * * *  *** ** *     *     *    *   * *    *** *  *  **        *       *  * ** *      *  **     * *    ** * *
  *     *  *    *   ***   * *  ** **    * ****    * *  **      *   *  *      * ** *  * * ****     *  ***      *  *      **      **       **** *  ***   **  *   ***  *  *  *** **  
    *  ****   * *   * **  *   * * *  *  *  ** ****     *   *** * **   ***  ** *** **   *  *  * * ** ** ******  ** ****  ** * * *  * **      *         *** ** * *  ***   *   **  **
** * *    *  * *   *    ** *  *  *** *        *  ** ** *   *  ** * *   * **  **** *           * *    **** *       * *     *  * ** * *  *   ** *   *** ** *   * ** **  * **   *** *
          * * * *     *  * *  ** **     *      ** **** *      *  *  *** * *****  *      *  * *  * **  ** *    *    * * *   **      *   **** *  *    * *   * **    ***     *     **
 ** *  **           **      *     * * *  *  ****    **  *  ***          **    * * **        *     * **    ** *        **  **  * *       * *  ** * * *       ****   ***      *  *  
*       *** *     **    * **** * *  **   **    ***                * *  *  *****   *   *   *      *  **   **  *  *  ***  * *  **     * *  ** * **       *   ***  *  ***    *       
    *     **  *   * ***  *  * *    * * *   * * * **      *   ***  ***  * * *  * * * *  * *** *  *   *     *  ******   * *    ****     ** **   **** * **  *   *  **  *  *  * *   * 
 **   *  *** *        ****  *  * *     ***  ***       *****  **   *    *  *  * ****        *       * * *   * *     **        * * *  ** ****** *****   *       *** *** *****  *   *
 **    *****        *  *** ** * ****  *** ** ***  * * **   ***   **   **** *** *   *     * ***  *  ** ********   *** ** *** **  **    *  * *  ***   *  ** *    *   * **  ***  *** 
 * *  *  *    *     **     *  *   * *  *  * *  *   ***  ** *      **        **      **         *  **     **     ** * * ****    ***  ***   **  **   ** ** * *    *     *  **** *** 
   *    *  *    **    ***** * *   * *   * *  * * *  ** *    ***  * *      ** * ** **  * *    ** * * **        *     **  ***     *       *    *       *  ** * *  * * *   **   *    
 ***  * ** *  ** **     * *   *** * **      *  * *     * * **   *  * * *    * * * *  * ***     * **           *     *  ** * **   *  *     *   *****   ** *   *   *  *  ** *  **   
  * * *  * ****    * * *  * ** * * **  *   * *        *  *   ** **  *   **   * *    ***** *** *   *  *  *  **    *     * *     **  ***   * **  *    *   *   ** * * *** **      ***
  *     * **       *** *     ** **   **** *******   *       ****  *** ***  * ***    ***      *   *** ****  * **** *   **   *** *      *  *   ** ***  * * * *  *       * *    ** * 
  * **  * * * *     *****    * *  * *    *    *  * * *   ****       * *    ****  ** *  * * *       *   *** *  * ****     * * *  **  *    **** ****    *  ****      * **  *** **** 
  ** ***    **  *  **   ***  *  **  * ** ** *   ***  *      * *  *  ** *  * *             **  *       * *** *   *  *      * **     ***** * * *      * *  *  * **     *   ** *  *  
** *        **   * ** *** **   *  **  ** * *  **   *** **    *  *    ****   ***** ** *    **  *** *   *  **  * **  *  *    *  ** *****  *   *     **   *    **   *        *** * * 
 *  **  *       ****    ***  * * *   *    **  **  * ** *    * **    * **   * *    * ****  *  * ** *  * *            **  * *   * *  **    * **     * *  *   ** *   *       ********
* *    *    ** **    * **  *    ***  *     * *   * *  **  * * * *      ** *    * *   * *** ** *   * *         *    *       **     *** ** * *           *    **  *  *   ***     ** 
 * ** *      **  *    **  *       *****   *  *** ** *        **    **   **    ***     *  *  ***      **    * *** ** * *  * *  *  * *     * ***  *  * ***   *      ** *    * *    *
*   * *  *  *    ** * *  * **    *    *  **  **    *  * **   * **  ** ***   *****    ****** *** ***  * * *   **   *   *   * **** *     *   * *  *   *  **  **    **  *** **  ** * 
   * *  *  *   **  ** ****  *  *     * ** *  *  * **** *    ** *** * **  *   **   *   * *       ** * *   *  ** * *    * ** *    **  *    **** **   *  ** *    *     *   **    *   
** * *  *      ** *  * ****   *   *     ***** ***  **** * *  *****  * * *  ** **     *  *  *  **  ** * * ** ****  **   * * *** **    **  **       * * **          *  ***   * *  **
* * **  * *  **    **  **         ******   *    *******  **  * ****    ** **   **  * *  ***    * *       **  *** *  *    * **       * ** **      *   * **** * *   *  *** *   *    
* * *  **  *** *    **  *******   ** *      **    *      ****  * *  *** *  * ****  *  ****  ****     *   ** *  ** ***** *   *  *  *  **** * *      *   ** *    * *   * *** *      
   **  *      *** **  *   ** *     ***** **     ****   * * ** * *   *  *   ** *   **  **  ***  *  *           ***     **** ****    *    **   *   * ** *  *  ***     **  *  *  *   
 ** * ** ** *** *  *       *   * *** *** **          **       **** ****      *   *     *  ** *   **    ** *  ** * *** *  ** * *** *  * * *   * * * ** ** * ***   ***      *     **
 *   *       *   **  * *   *****            * * * **  *  * *   ******   *   *  * ** **  *       **    ***  ** ******    * * ** * *  * **   ** *  * *      *   **   *  * *   ***   
* ****  ***  * *  ** *** *  *  * * *  *   * *  *  * *** *     * *  *   *   **   *    *  **   *  ***  * *      ****  *** * * *  *  *  * *     ****  * *** ***** ***** ** ** *   *  
*     ***   ****       *****  *  *   * ***  ***   * * * *  ** *     * *     **    ** *    *  **  **    **   *  **     * ***** ***     **     * ** **  *  **   *     *****   * ** *
 ** ** **  **    *** *     *  **       *   **  *    *    * * * *** * * **     *  **   * *  *  *   *    * *     ***  *** * *  * * * *** ** **      *    **  *****       * * * *  * 
 *   *  ***    **  *     **  ****   * *    **     * **  *  * ** ******* **  * *  **   *  * * ***    * **   ** * *    ** ***   *   ** *** ** * **     *   *  * *  * ** *           
 *    ***             *   **  * *   *  * ***   ** *   *       **  * ** *** *  * **    *    *  **  * ** *    * **** *  *    ***  *  *  *     *   ** **  * **    * *** *    *  *** *
 *  ** ***  *    *       *   * * **    * ***** * *     *   **  **  * ** *    *  *  *  * * **   **    **   *    * * *    ****   * * *     *****  *  ** **     * *****   *  ** *    
  ** * *       **  * ** **  **    **  * *  * *      * * *    *  *** **   **     *  * ** * *  * * *    **   *      *  *   * * *   *   **  *  *    ****       *  ***  * *** *  **   
* ** *  **  *      *  ** **    *  ** ***      *    * ** * *  *** *  *  *  *    *  *      * * *  **  *  *  *   *  *   * *    *  *  *   **** ** *  * *  * **   **   * *    * *    * 
  ***    * * * * *****   **    **  * ** * *     *   *     **  *** **    ****    ** *   * * *   *  ** * **  *   ** *  ** *  *** **   ** *** **  **          **  * ** **     *   * *
    *  **** *  * *          ***   * *  *   **   *  **  *  ** *  **  *   *       *    *  *        ** *      *** *   *  *     * * ** * ** *** *  **   * *  * * * ** **    ** **     
      ***     **  *      * * **   * *      ***   *          ** * *  *** *  *   **** ***     ** *  ** * *  ***   *   ***  *******   ***  * ****      *      *   *   *  * **     *  
** * * ***  *  *       *   * **    ** **  * *   ***   * *  * *     * *      **   *   * ** *  *  *  *      ***  **   ***      ** *  *  *   *  **  **          *       * *    * *   
**  * * ***   *** *        *** * **  ***** * ***   *     **** * * *   * *      * ** * *  ** *  *     *    ** *     *  **       * **  * **  **     *    *** ** *   *   *         * 
 ***  ** *** *  ** **  *     *   *   * * *   ** **     * *  *    ** *    ****** * ** ***           *     *  **** **  *   * **     *  *  *  **** ***    *  * *  **   *   *    * ** 
** *   * *     *   *  *  ** ** * * *  *   * * * *  **   * *  ** *   *   **  *  *    *       *   ***    * **    *   **       *   *   *   **    ** * *     *   *   **  *  * *   **  
  ** ***  *  **** *** * *     ***    * *** * *****     * * ** *** ****   **   *** *   *   *    * **  **     ***    * ** *    * * **   * * * * ** *           **  * *   ** *       
