 ..  .              .   .      .    .      .     ...               .   .            .  .    .  .   .                 .        .     .         ..                    .         .   
..  .       .   .    .  .      . ..       .           .      .  .         .  .     .    .       .       ..        .  .    ..     ..            . ..   .   . .  .  ..     .    .  .
  . . .              .   .   . .    .  .      .  .  .  .  ..      .         .    . .     ..                          .   .      . . .. . .       .       ..     ..     .    ..   .
.   .                 ...         . ...  ..   . ..  .    . ..       .         .  .  .                          .     .     . .    .    ..                                   .  .  
        .       .          . ..    .         .. ....     .   . . .      .  . .  .    .               .   .          .  .      .                      .    .            .        . 
  . . .  .               .    . .. .  .         .. . .     .          ..             .   ..  .       .      . .   . .   ..     .               .      . .                .        
    .  .   .. ..         .     .      .     .  .      . .                .  . .   .   .            .   .     .     .           .   ..   . ..   .  ..        .    ...           . .
       .      .   .      . .   .       .     . .         ..                 .    .   ..  . . ..    .     .     ..     .     .    .  .   ..      .  .  .     .  . .     .      . ..
  .      ...        ..   ..            .....  .          . .      .  ... .. .      .    .  . ..  .             ..   .  . . .  .        ..       .   .            . . .  .   . .   
     .   .      ..     .    .           .         . .    .       .  .       .                    .     .  .  .. .     .     . .  ..   .                    .  .        .       .  
    .         .           .  ..  .    .   .   . .   ..          ..           .   .    .  .          .   .       .    .            .      ..     .          .. .      .     .   .  
       .       .    .     .  . .  .     .   .. ....         ...   .   .    . .          ..  . .. .    .        ..         .  .  .  .           .      .               .    .   .  
 .  .    .                   .   . .      ..      . .               . .    .   .  .   .. .    .             .    . .   .     .     .           .    . .           .   ..          
  .                 .  .                    .  . .      .     . .  .       .  . .   .  .   .                     ..   ...  .  .          .             .     .       .   .   .    
    .   . .  .      .  .  .  .     .  .          .. .        ..    .   .        ..       .    .            .   .   .. .              .  .    .   .  .          .  . .     .      .
.          ....  .  ..  .     .  . .      . .      ..   .    .  . .    .            .   . .       ..      .  .  .         .  ..   .      .     .    . . .   .          .       . .
   .   .     . .      .           .  .    .           ..         .  ..     .     .         .     .     . .     .  . .  .        . .        .  .  . .     . . .    ..     .  . .   
  .  .  .   .      .          ..      .              .             ..    .  .  .       .   .                     .   .  .   .       ..          .     .. ..     ..           .  . 
           .    .   .         ..         .   . . .                            .                      .   .  .           .             .  . . ..         .       .             .   
. .  ..       .             . .    .   .    . .  .         .    ..          . .  .    ....    .. ..   .        ..     .           .        .    .           .      .         .  . 
 . .     .          .      .. . .     .... .   .   .        . ..      .   .   .    .   . . . ..   .. . .  . ... .        .  .            . . .       .  ..            ..    .    .
      ..  .        ...   .   .    .   .    .      ..       .   .       .       ...  .  .        ..        .             . .  .     .  .    .      .   .    .         .   .     .  
          ..     .        .   .          .. ...     .         . ..     .    .           . .   .           ..  .  .      .   .       . .  .              .       ..        .       
  . .      .     .    .       .         .   .  .      . .    .  .   .   .  .       . .  .        .   ..    ..      .      .. .    .  .             .             . ...            
.        .              ..          .. .         .. .    . ..  .         .   ..  . . .       .    . .        .    .        .         .      . .    ..   .  .            .      .  
                .  ..        .. . . . . ..  ..  ..       ..      .    . .   .        . .  ..            .       .. ..  .               ..       . .  .          ..                
  . .  . .. .      ..          .  .       ...             .   .  .  .. ...                     .        . . ..      ..  .     .           .              .            .    . .  . 
   .   ..           .        ..     .....         .       .     .   .         . ..     .          .          .    .       .  ..  . .           .     .    .      ..   .    ....   
  ..   .. .        .  .    .    .          .       .          .   .. .. .. .             ...    .      .    .         .        . .      . .                . .   .. .             
            ..      .               .  .      ...   ..          .     .       ..            ..   .  .   .      ...   ..   .. .      ..   . .       .   .     . .       .  . .    .
.    . .                 .  .  .         ...         .    ..         .        .       . . .         .   .    ... . .    .              .         .     .            .  .  .  .  . 
     .. .       .     . .         ..  .    . .. .    .      .       .     . .  . .  .         .  .           .     .  .  .. .   . . .   .     ..           .. . .            . . .
..... .  .    .       .     .   .      .  ..   .      .        .       .     .         .   .     ...              .  .   .          .       .          .       .      .  .   .   .
 .           . . . ... .         .   . .       .  .       .   .     . .     .      ..                     ..       .  .                    .           . .       .          .    .
  .          . . .     . . .  ..  ...                          .               .         .        .           ..   .      .       .        . . .       .         .  .  .    .     
  ..   . .            .   . .           .    .        .         ..    . .  .    .  .   . .      .   .      .             .  .    .    .  .   ..    .     .  .  ..     .  .     . .
 .     . .  .     .  . .  .    . ..       ..   ..                 .     .     .. .       ..  .       .  .       . .            .      .            .  .  .          ...    .  .   
                  ..    . . .      ..       .  . ..      .   .     ..    .         .        . .  .    ...  .   ..   . .     .                .  .      ...          .   .  .. .   
    .   .. .           .   .   .        .        .     .           ..              ...   ..           .   ..          ..  .  .  .       .              .    .   .          .  .   
   . . ..      .        . .   .   .        . .   .  ..      .  ..       .  . .     .     .     .       ..         .           .  ..  . .   . .   ..    .                    .     
 .     . .  .     ..      .  .  .          .     .     .             . . .   .      .     . . .       .    ..      .    .                 .        .               .           .  
    . ..   .   ..    .     .  . .   .  .        ..    ..   .  ..              .       . .     .        .                      .     . .        . .      .     ...  . .   .        
              .      .        .  .          .     .  ..    ..        ..                . . .     .                                ..  ...    .  .    .  ..   .       .. .     .   
.      .   .   .        .....       .    .         .                 . .   .            ..       .. .   .   .    .  .     . .   .          .                 .       .          . 
    .   . ...   . .                 . .      ..   .    .     .  .              . .         .               .         .. .  .  .                      ..                      .    
           . .       ..     .     .            .         . .          .       .   .  .    .  .  .   . .     . .       ..   .     ...           .     .      .    .       .        
 .   .   .   ..     .   .       .            . .   ..                 .  .     .     . .      .. . .   .  ..       ..   ..  . .  .  . .                .   .       .        ..    
